S..#####.#..###
.#.....#.##.#..
..##.#...#....#
#...####...####
...#.....###..#
##.####.##...##
...###.....####
.#...##.#.##..#
.##.#...#....##
###..####.#####
###.##.#..##..#
#...#..#.##..##
..##..#.....###
#.##.###.##.###
#....###..#...G
