.#####.#..###..
.#.....#.##.#..
..##.#...###..#
#...####.......
##.....###..###
##.####.##...##
S..##...##.####
.#...##....#..#
.##.#...#....##
###..####.##..#
###.##.#..##..#
#...#..#.##..##
..##..#.....###
#.##.###.##.###
G....###..#...#
