...###.#..###.#
.#.....#.####.#
..##.#...###..#
#...####.......
##.....###..###
##.####.##...##
S..##...##.####
.#...##....#..#
.####...#....##
###..####.##..#
###.##.#..##..#
#...#..#.##..##
..##........###
#.##.###.##.###
G....###..#...#
