...###.#......S
.#.....#.##.#..
..##.#...##.###
#...####.......
##.###..#######
##.#....##...##
#..#.##.##.####
##...##....#..#
#####...#....##
###...#...##..#
###.####..##..#
#...#....##..##
..##...##...###
#.##.######...G
#.........#####
